9 9 9 9 9 9 9 9 9 9
9 0 0 0 0 0 0 0 0 9
9 0 0 0 0 0 0 0 0 9
9 0 0 0 0 0 0 0 0 9
9 0 0 9 9 9 9 9 9 9
9 0 0 9 8 8 8 8 8 8
9 0 0 9 8 7 7 7 7 7
9 0 0 9 8 7 6 6 6 6
9 0 0 9 8 7 6 5 5 5
9 0 0 9 8 7 6 5 5 5
9 0 0 9 8 7 6 6 6 6
9 0 0 9 8 7 7 7 7 7
8 0 0 8 8 8 8 8 8 8
7 0 0 7 7 7 7 7 7 7
6 0 0 6 6 6 6 6 6 6
5 0 0 5 5 5 5 5 5 5
4 0 0 4 4 4 4 4 4 4
3 0 0 3 3 3 3 3 3 3
2 0 0 2 2 2 2 2 2 2
1 0 0 1 1 1 1 1 1 1