0 0 0 0 0 0 0 0 0 0
0 0 0 0 0 0 0 0 0 0
0 0 4 4 4 4 4 4 0 0
0 0 4 5 5 5 5 4 0 0
0 0 4 5 6 6 5 4 0 0
0 0 4 5 5 5 5 4 0 0
0 0 4 4 4 4 4 4 0 0
0 0 0 0 0 0 0 0 0 0
0 0 0 0 0 0 0 0 0 0
0 0 4 4 0 0 4 4 0 0
0 0 4 3 0 0 3 4 0 0
0 0 4 3 0 0 3 4 0 0
0 0 4 3 0 0 3 4 0 0
0 0 4 3 0 0 3 4 0 0
0 0 4 3 0 0 3 4 0 0
0 4 3 2 0 0 2 3 4 0
4 3 2 1 0 0 1 2 3 4
3 2 1 0 0 0 0 1 2 3
2 1 0 0 0 0 0 0 1 2
1 0 0 0 0 0 0 0 0 1