0 0 0 0 0 0 0 0 0 0
1 5 2 1 1 2 3 4 5 6
1 4 3 2 3 4 1 2 3 5
1 3 4 4 5 6 7 12 12 4
1 2 5 6 7 8 9 10 11 12
0 0 0 0 0 0 0 0 0 0
1 5 2 1 1 2 3 4 5 6
1 4 3 2 3 4 1 2 3 5
1 3 4 4 5 6 7 12 12 4
1 2 5 6 7 8 9 10 11 12
0 0 0 0 0 0 0 0 0 0
1 5 2 1 1 2 3 4 5 6
1 4 3 2 3 4 1 2 3 5
1 3 4 4 5 6 7 12 12 4
1 2 5 6 7 8 9 10 11 12
0 0 0 0 0 0 0 0 0 0
1 5 2 1 1 2 3 4 5 6
1 4 3 2 3 4 1 2 3 5
1 3 4 4 5 6 7 12 12 4
1 2 5 6 7 8 9 10 11 12
0 0 0 0 0 0 0 0 0 0
1 5 2 1 1 2 3 4 5 6
1 4 3 2 3 4 1 2 3 5
1 3 4 4 5 6 7 12 12 4
1 2 5 6 7 8 9 10 11 12
0 0 0 0 0 0 0 0 0 0
1 5 2 1 1 2 3 4 5 6
1 4 3 2 3 4 1 2 3 5
1 3 4 4 5 6 7 12 12 4
1 2 5 6 7 8 9 10 11 12
0 0 0 0 0 0 0 0 0 0
1 5 2 1 1 2 3 4 5 6
1 4 3 2 3 4 1 2 3 5
1 3 4 4 5 6 7 12 12 4
1 2 5 6 7 8 9 10 11 12
0 0 0 0 0 0 0 0 0 0
1 5 2 1 1 2 3 4 5 6
1 4 3 2 3 4 1 2 3 5
1 3 4 4 5 6 7 12 12 4
1 2 5 6 7 8 9 10 11 12